R 1280 720
NO ./texture/N.xpm
SO ./texture/S.xpm
WE ./texture/W.xpm
EA ./texture/E.xpm
S ./path_to_the_sprite_texture
F 0,121,219
C 102,102,102

1111111111111111111111111
1000000000000000000000001
1000000010000000000000001
1000000000001000000000001
1000000010000000000000001
1000000000000000000000001
10000000000S0000000000001
1000010000001000000000001
1000010000011100000000001
1000010000001000000000001
1000000000010000000000001
1000000000100000000000001
1111111111111111111111111
