R 1280 720
NO ./texture/N.xpm
SO ./texture/SO.xpm
WE ./texture/W.xpm
EA ./texture/E.xpm
S ./texture/S.xpm
F 0,121,219
C 102,102,102

11111111111111111111111111111111
10000000000000000000000000000001
10000000100000000000000000000001
10000000000010000000000000000001
10000000100000000000000011111111
1000000000000000000000001
10000000000E0000000000001
1000010000001000000000001
1000010000011100000000001
1000010000001000000000001
1000000000010000000000001
1000000000100000000000001
1111111111111111111111111
