R 1240 720
NO ./texture/N.xpm
SO ./texture/SO.xpm
WE ./texture/W.xpm
EA ./texture/E.xpm
S ./texture/S.xpm
F 0,219,255
C 102,102,102

        1111111111111111111111111
        1000000000110000000000001
        1011000001110000000000001
        1001000000000000000000001
111111111011000001110000000000001
100002000000000001110111111111111
10000000000001011100000010001
10000002000000011101010010001
10000200000001011100000000001
10000000200000001100000010001
10000000000000001101010010001
10000000001010111110111100111
1000000N00000101 101111010001
1111111111111111 111111111111
