R 1280 720
NO ./texture/bluestone.xpm
SO ./texture/greystone.xpm
WE ./texture/mossy.xpm
EA ./texture/redbrick.xpm
S ./texture/barrel.xpm
F 102,102,250
C 0,0,0

1111111111111111111111111111111111111111111111111111111111111
1222222222222222222222222222222222222222222222222222222222221
1222222222222222222222222222222222222222222222222222222222221
1222222222222222222222222222222222222222222222222222222222221
1222222222222222222222222222222222222222222222222222222222221
1222222222222222222222222222222222222222222222222222222222221
1222222222222222222222222222222222222222222222222222222222221
1222222222222222222222222222W00000000000000000000000000000001
1111111111111111111111111111111111111111111111111111111111111









